0 0 1 0 0 0
0 4 7 7 7 0
0 7 7 7 7 2
0 7 7 7 7 0
0 0 7 5 7 0
7 0 0 0 0 0